##########
#        #
#    @   #
#        #
#        #
#        #
#   $    #
#   .    #
#        #
##########
