##########
#@       #
###   $  #
#   $  # #
# #    # #
# $    #.#
###    ###
#.    $  #
#  . .   #
##########