##########
#@       #
####     #
#    $####
#        #
#   #  $ #
#    $#  #
###.# #.##
#   #.   #
##########
