##########
#@    . ##
### ## $ #
#   ##   #
# $ ## $ #
#   $   $#
# . # .  #
#      #.#
###.######
##########
