##########
###   @ ##
##       #
#        #
#      . #
###  $   #
#   .   ##
##    $  #
#        #
##########